e==========r e==========r
|°°°°°°°°°°| |°°°°°°°°°°|
|°e==r°e=r°| |°e==r°e=r°|
|°|  |°| |°d=f°|  |°| |°|
|°d==f°d=f°°°°°d==f°d=f°|
|°°°°°°°°°°e=r°°°°°°°°°°|
|°e==r°er°ef dr°er°e==r°|
|°d==f°||°d===f°||°d==f°|
|°°°°°°||°°°°°°°||°°°°°°|
d====r°|d==r°e==f|°e====f
     |°|e==f°d==r|°|
=====f°df°°°°°°°df°d=====
      °           °
=====r°er°e===r°er°e=====
     |°||°|   |°||°|
e====f°||°d===f°||°d====r
|°°°°°°df°°°°°°°df°°°°°°|
|°e==r°°°°e===r°°°°e==r°|
|°d=r|°er°|   |°er°|e=f°|
|°°°df°||°d===f°||°df°°°|
d=r°°°°||°°°°°°°||°°°°e=f
  |°er°|d==r°e==f|°er°|
e=f°df°d===f°d===f°df°d=r
|°°°°°°°°°°°°°°°°°°°°°°°|
d=======================f